NO ./textures/eagle.xpm

SO ./textures/redbrick.xpm

WE ./textures/eagle.xpm

EA ./textures/eagle.xpm

F 255   , 0   , 0

C 10,189,227


111111111111111
100000111111111
100000111111111
100000111111111
110000111111111
101110111111111
10N00000000001
100000000000001
100001000000001
100011000000001
10001 111111111
10001 111111111
11001 111111111
  111 111111111
     1111111111   
     1000000001  
     1000000001  
     1000000001  
      111111111      