NO ./textures/redbrick.xpm

SO ./textures/mossy.xpm

WE  ./textures/redbrick.xpm

EA ./textures/redbrick.xpm


F 19, 15, 64

C 104, 109, 224


111111111111111
1000001111111111111111
10000010000000011000011
100000S0100010000100100111
1000000010001000000110011
100000001001 11000011111011
1000001000011110000000001
10000010000010000100000001
1000010000000000000000001
1100001111111011111111111
100110000000001      1001 
111111111111111111111111