            NO ./textures/redbrick.xpm

        SO ./textures/redbrick.xpm

    WE  ./textures/redbrick.xpm

        F  25    ,      62     ,       80

             C    104,109,224

         EA ./textures/redbrick.xpm

111111111111111111111111111
1000000000000111100N000000011
11111111100001  10000000000001
    1111100001111000000111111
    10000000000000000001
    1111111111111111111