NO ./textures/eagle.xpm

SO ./textures/redbrick.xpm

WE ./textures/eagle.xpm

E ./textures/eagle.xpm

F 34, 47, 62

C 10,189,227


11111111111111
10000100000001
1000N001111111
11111111111111
11111111111111
11110001111111
11110101111111
11111101111111
11111111111111