NO ./textures/redbrick.xpm
SO ./textures/redbrick.xpm
WE ./textures/redbrick.xpm
EA ./textures/redbrick.xpm

F 220,100,0
C 225,30,0

1111111
111N111
1111111