NO ./textures/eagle.xpm

SO ./textures/redbrick.xpm

WE ./textures/eagle.xpm

EA ./textures/eagle.xpm

F 255   , 0   , 0

C 10,189,227


1111111111111111111111       111
1000001111111110000111       111
1000001111111111110111       111
100000111111111  10111       111
110000111111111  101111111111011
101110111111111  101110001111111
10000000N000001  100000001111001
100000000000001  100000001111111
100001000000001  110000001110111
100011000000001  110001101110111
10001 111111111  111110011110111
10001 111111111  111110111111111
11001 111111111  111111 11111111
  111 111111111  101111 11111111
     1111111111  101110111111   
     1000000001  100000011111   
     1000000001  110000011111   
     1000000001   100010111 1   
      111111111    11111        