NO ./test.xpm

SO ./test.xpm

WE ./test.xpm

EA ./test.xpm

F 220,10,10

C 210,30,0


                                                                            0001
            111111111111111                                     1111111111
                    1000000             000110000000000001
        101100                                  0001110000000000001
        1001000000000000000000001
111111  11101100000111  0000000000001
1000000                     00011000001110111111111111
1111011 111111101110000 0010001     
11110111    111111011101010010001
11000000110101011100000010001
            0010000000000000001100000010001
1000000 0100000001101010010001
            11000001110101011111011110N0111
11                  110111 1110101 10111101                 0001
11111111 1111   111 111111111111
101010101           0101010000  0101010000 0101010000 0101010000
10101010 1 0 1 0 1 0 1 0 1 0 1 1 1 1 1 1 1 1 1 1 0 1 0 1 0 1 0 1 11111