NO ./test.xpm

S ./test.xpm

WE ./test.xpm

EA ./test.xpm

F 220,10,10

C 210,1,0


1111111111111111111111111111
1111111010101010110101011111
1001011000001110000000000001
1001001000000000000000000001
1000000000000110000000000001
10000000N0110000011101111111
1111011111111101110000001001
1111011111111101110101001001
1100000011010101110000001001
1000000100000000011000000101
1000000000000000110101001001
1100010111010101111101111001
1111011111110101110111101001
1111111111111111111111111111